EA ./textures/east.png
NO ./textures/north.png
SO ./textures/south.png
WE ./textures/west.png

C 255,255,255
F 255,255,0

1111
10W1
1111