EA ./textures/east.png
NO ./textures/north.png
SO ./textures/south.png
WE ./textures/west.png

C 255,255,255
F 255,255,0

111111111111111111111111111111111111111111111111111111111111
100000000100001000010000000000000000000000000000000000000001
101111000000000000110000000000000000000000000000000000000001
100000001100011101110000000000000000000000000000000000000001
101110000100011100010000000011111100011111111111100000000001
101010000100011101000000000000000100000000000001000111000001
100010000000000000110000000000000100000000000001000100001001
111111111111111111110000000000000100000000000001000100010001
100000000000000000000000000001111100000000000001000100100001
100000111100000000000000000000000000000000000001000011000001
100000000100000000000000000000000000000000000001000000000001
100000000100000000000000N00000000000000000111111000000000001
111111111100000000000111111111111000000000000001000000000001
100001000000000000000000000010001000000000000001111111100001
100111000000000000000000000010001000000000000001000000100001
100100000000000000000000000011111000000000000001000000100001
100100000000000000000000000000000000000000000001000111100001
101111111110000000111111111111101000000000000010000000000001
100000000000000000000000000000000000000000000000000000000001
111111111111111111111111111111111111111111111111111111111111