NO textures/north.png
SO textures/north.png
WE textures/north.png
EA textures/north.png
    
F 120,100,88
C 125,30,90

11111
10001
10N01
10001
11111